20 20 0 4
00000000000000000000
00000000000000000000
00000001000100000000
00000100000010000000
00000101010100000000
00000110010000000000
00001100101010000000
00011111100001000000
00011001010000000000
00000011010000100000
00001000010001000000
00001001100000000000
00000011010000000000
00000010110000000000
00000010001000000000
00000010001000000000
00000001000000000000
00000001000000000000
00000001000000000000
00000001111110000000