50 50 3 22
10111111111111111111101111111110111111111111111111
10100001100000000000001111100010100000001000100001
10001101101011111111111000101010101110101010100001
10110100101000000000000010101010100100101010100001
10100010101111111110111110101010110101101010100001
10100000100000000010100010101010010101001010110001
10101111111111111010101010101010010101011010010001
10100000000000001010101010101011010101001011010001
10111111111111101010101010101000010101101001010101
10100000000000101010101010101111010100101101010101
10101111111110101010101010100001010110101101000101
10101000000010101010101010111101010000100001111101
10101011111010101010101010000101011110111111000001
10101010000010101010101010000101000000000000011101
10101010111110101010101010000101101011111111111101
10101010000000101010101000000100101000000000000001
10101011111111101010101111111110101111111111111111
10101000000000001010100000001000100000000000000011
10101111111111111010111111101011111111111111111011
00100000000000000010000000001000000000000000001000
11111111111111111111111111111111111111111111101111
00000000000000000000000001000000000000000000100000
11111111111111111111111101010001111111111110111111
00100000100000000000000101010101000000000010000000
10101110101111111111110101000101011111111001111111
10101000101000000000010101010001010000001100000001
10101011101011111111010101010101010111101111111101
10101010001010000001010101010101010010001000000101
10101010111010111101010101010101011010111011110101
10101010100010100101010101010101001010111000000001
10101010101110100101010101000001101010000111110101
10101010101000100101010101011111101011110000000101
10101010101011100101010101010000001000111111111101
10101010101010000101010101010111111010100000000001
10101010101010101101010101000000000010001111111111
10101010101010101101010101011111111011111000010001
10101010101010100001010101000000001000000011010101
10101010101010111001010101011111101111111111010101
10101010101010001001010101000001001100010001010101
10101010101011101001010101111101011101010101010101
10101010101000101001010101000001000001000101010101
10101010101110101111010101011111111111111101010101
10101010100010100000010101000000000000000001010101
10101010111010111111110101111100001111111111010101
10101010001010000000000101000111111000000000010101
10101011101011111111111101010100011011111111110101
10101000001000000000000001010001001000000000000101
10101111111111111111111111011111101111111111111101
10100000000000000000001111000000100000000000000001
10111111111111111111101111111110111111111111111111