41 41 7 11
11111111111111111110000000000000000000000
10100000010000000010111111111111111111111
10101111010111111010000000000000000000001
10101000010100001010111111111111110111101
10101011110101100010000000000000010000001
10101000010100111111111111111111010111101
10101111000100000000000000000000010100001
10100001111111111111111111111111110101101
10111100000000000000000000000000000101001
10000111111111111111111111111111111101001
10110000000000000000000000000000000000001
10110111111111111110111111111111111111101
10000100000000000010100000000100000000101
10111101111111111010101111110101111110101
10000001001000001010101000010101000000101
10111111000011101010101000000101011111101
10100000000100001010101011111101000000101
10101111111101111010101010000101111110101
10101000000100001010101010110101000000101
10101011110101101010101010100101011111101
10101010000100001010101010101101000000100
10101010111111101010101000100001111110111
10101010110001101010101111111111000010100
10101010000100001010101000000000011000101
10101011111111111010101011111111111111101
10101000000000000010101010001000010001001
10101111111111111110101010101011010101011
10101000100010000010101010101000010101001
10101010101010101010101010101010010101011
10101010001010101010101010101011000100001
10101010101010101010101000100000001111101
10101010101010101010101111111111111000101
10101010101010101010100000000000000010101
10101010101010101010111111111111111110101
10101010101010101010000000000000000000101
10101010101010101011111111111111111111101
10101010101010101000000000000000000000101
10100010001000100011100000011111100000001
10111111011111111111111111111111111111111
10000000000000000000000000000000000000000
11111111111111111111000000000000000000000